{
  "map": [
    ["l","l","l","l","l","l","l","l","l","l"],
    ["l","l","l","l","l","l","l","l","l","l"],
    ["s","s","s","s","s","s","s","s","s","s"],
    ["s","s","s","s","s","s","s","s","s","s"],
    ["g","g","g","g","g","g","g","g","g","g"],
    ["g","g","g","g","g","g","g","g","g","g"],
    ["l","l","l","l","l","s","s","s","g","g"],
    ["l","l","l","l","l","s","s","s","g","g"],
    ["l","l","l","l","l","s","s","s","g","g"],
    ["l","l","l","l","l","s","s","s","g","g"]
  ]
}